bank_account_key,start_date,end_date,cash_change,ending_balance,calc_balance,period_status
104Meadow,1/1/24,1/31/24,1453.8,2584.39,2584.39,closed
104Meadow,2/1/24,2/29/24,1144.8,3729.19,3729.19,closed
104Meadow,3/1/24,3/31/24,-805.2,2923.99,2923.99,closed
104Meadow,4/1/24,4/30/24,2635.8,5559.79,5559.79,closed
108Meadow,1/1/24,1/31/24,1335.07,2545.88,2545.88,closed
108Meadow,2/1/24,2/29/24,1026.07,3571.95,3571.95,closed
108Meadow,3/1/24,3/31/24,-823.93,2748.02,2748.02,closed
108Meadow,4/1/24,4/30/24,2417.07,5165.09,5165.09,closed